# Arduino Syntax Highlighting

RTC_DATA_ATTR	LITERAL1
ulp_var_t	KEYWORD1
ulp_insn_t	KEYWORD1


hulp_ulp_run	KEYWORD2
hulp_configure_pin	KEYWORD2
hulp_peripherals_on	KEYWORD2
hulp_ulp_load	KEYWORD2
hulp_ulp_isr_register	KEYWORD2
hulp_ulp_interrupt_en	KEYWORD2
hulp_configure_analog_pin	KEYWORD2
hulp_is_deep_sleep_wakeup	KEYWORD2


R0	LITERAL1
R1	LITERAL1
R2	LITERAL1
R3	LITERAL1

I_MOVI	LITERAL1
I_MOVR	LITERAL1
I_ADDI	LITERAL1
I_ADDR	LITERAL1
I_SUBI	LITERAL1
I_SUBR	LITERAL1
I_LSHI	LITERAL1
I_RSHI	LITERAL1
I_LSHR	LITERAL1
I_RSHR	LITERAL1
I_STAGE_RST	LITERAL1
I_STAGE_INC	LITERAL1
I_STAGE_DEC	LITERAL1
I_ST	LITERAL1
I_LD	LITERAL1
M_LABEL	LITERAL1
M_BX	LITERAL1
I_BGE	LITERAL1
M_BGE	LITERAL1
I_BL	LITERAL1
M_BL	LITERAL1
I_BXR	LITERAL1
I_BXF	LITERAL1
M_BXF	LITERAL1
M_BSLT	LITERAL1
I_WAKE	LITERAL1
I_HALT	LITERAL1

I_GET	LITERAL1
I_PUT	LITERAL1
I_ANALOG_READ	LITERAL1
M_WAKE_WHEN_READY	LITERAL1